+-+-----------------------+
|S|W                     W|
| |    +--------------+   |
| |    |             W|   |
| |    |   ------+    |   |
| |    |        T|    |   |
| |    +---------+    |   |
| |W                  |   |
| +-------------------+   |
|                        W|
+-------------------------+
